# Map file for tile-based game 
# (Lines that start with '#' are comments)
# The tiles are:
#   (Space) Empty tile
#   A..Z    Tiles A through Z
#   o       Star
#   !       Music Note
#   *       Goal
#   1       Bad Guy 1 (grub)
#   2       Bad Guy 2 (fly)
O         ABBBBBBBBBBBBBBBBBBBBBBBBBBBBBBBBBBBBBBBBBBBBBBBBBBBBBBBBBBBBBBBBBBBBBBBBBBBBBBBBBBBBBBBBBBBBBBBBC
N         DEEEEEEEEEEEEEEEEEEEEEEEEEEEEEEEEEEEEEEEEEEEEEEEEEEEEEEEEEEEEEEEEEEEEEEEEEEEEEEEEEEEEEEEEEEEEEEEEF
N         GHHHHHHHHHHHHHHHHHHHHHHHHHHHHHHHHHHHHHHHHHHHHHHHHHHHHHHHHHHHHHHHHHHHHHHHHHHHHHHHHHHHHHHHHHHHHHHHHK
N                                                                                                          O
N                                                                                                         *N
N                                    2                                                             ABBBBBBBN
N                                         2                                                        GHREEEEEN
N                                              2                                                 UV  GHHHHHN
N                                                              o                                 WX        N
N                    oooooooo                                  O                               UV          N
N                 ABBBBBBBBBC                                  N                               WX          N
N                 GHREEEEEEEF                                  N      UV                     UV            N
N               UV  GHHHHHHHK              UV                  N      WX                     WX            N
N               WX                         WX          UV      M                         1                 N
N             UV                                       WX                        UIIIIIIIV                 N
N             WX                               UV                                N=======N                 N
N           UV                                 WX              o                 N9999999N                 N
N           WX o           3 P    o                            P      1   1      N9999999N31313131313131313N
WIIIIIIIIIIIIIIIIIIIIIIIIIIIIIIIIIIIIIIIIIIIIIIIIIIIIIIIIIIIIIIIIIIIIIIIIIIIIIIIIIIIIIIIIIIIIIIIIIIIIIIIIIIX