# Map file for tile-based game
# (Lines that start with '#' are comments)
# The tiles are:
#   (Space) Empty tile
#   A..Z    Tiles A through Z
#   o       Star
#   !       Music Note
#   *       Goal
#   1       Bad Guy 1 (grub)
#   2       Bad Guy 2 (fly)
                                                                 
O         JILPJILPJILPJILPJILPJILPJILPJILPJILPJILPJILPJILPJILPJILPJILPJILPJILPJILPJILPJILPJILPJILPJILPJILPJO
N                                                                                                          N
N         JILPQR                                                                                           N
N         ABCOST                                                                                           N
N         DEFNUV                                               M                                          *N
N         GHKMWX                     2                         N                                   QRABCABCN
N                                         2                    N                                   STDEFDEFN
N                                              2               N                                 UV  GHKGHKN
N                                                              N                                 WX        N
N                                                              N                               QR          N
N                                                                                              ST          N
N                                                                     UV                     UV            N
N                                          UV                         WX                     WX            N
N==UV  QR==UV==UV==QR==UV==UV==QR==UV==UV==QR==UV==UV==QR==UV==UV==QR==UV==UV==QR==UV==UV==QR==UV==UV==QR==N
N99WX99ST99WX99WX99ST99WX99WX99ST99WX99WX99ST99WX99WX99ST99WX99WX99ST99WX99WX99ST99WX99WX99ST99WX99WX99ST99N
N99UV99QR99999999999999999999999999999999999999999999999999999999999999999999999999999999999999999999999999N
N99WX999999999999999999999999999999999999999999999999999999999999999999999999999999999999999999999999999999N
M99JI999999999999999999999999999999999999999999999999999999999999999999999999999999999999999999999999999999M
JILPJILPJILPJILPJILPJILPJILPJILPJILPJILPJILPJILPJILPJILPJILPJILPJILPJILPJILPJILPJILPJILPJILPJILPJILPJILPJILP