# Map file for tile-based game
# (Lines that start with '#' are comments)
# The tiles are:
#   (Space) Empty tile
#   A..Z    Tiles A through Z
#   o       Star
#   !       Music Note
#   *       Goal
#   1       Bad Guy 1 (grub)
#   2       Bad Guy 2 (fly)
                                                                 
O         ABBBBBBBBBBBBBBBBBBBBBBBBBBBBBBBBBBBBBBBBBBBBBBBBBBBBBBBBBBBBBBBBBBBBBBBBBBBBBBBBBBBBBBBBBBBBBBBBC
N         DEEEEEEEEEEEEEEEEEEEEEEEEEEEEEEEEEEEEEEEEEEEEEEEEEEEEEEEEEEEEEEEEEEEEEEEEEEEEEEEEEEEEEEEEEEEEEEEEF
N         GHHHHHHHHHHHHHHHHHHHHHHHHHHHHHHHHHHHHHHHHHHHHHHHHHHHHHHHHHHHHHHHHHHHHHHHHHHHHHHHHHHHHHHHHHHHHHHHHK
N                                                                                                          O
N         ABBBBC                                       3                                                   N
N         DEEEEF                                                        1                                  N
N         DEEEEF                                               O                                    3     *N
N         GHHHHK                     2                         N          1                        ABBBBBBBN
N                                         2                    N           1                       GHEEEEEEN
N                                              2               N             1                   UV  GHHHHHN
N                                                              N               1                 WX        N
N                                                              M                               UV          N
N                                                                                              WX          N
N                                                     1                AC                  AC              N
N                                          UV                          DF        1         DF              N
N  AC  QR  UV  UV  UV  UV  UV  UV  UV  UV  WX  UV  UV  UV  UV  UV  UV  DF  UV  QR  UV  UV  DF  UV  UV  UV  N
N  DF  ST  WX  WX  WX  WX  WX  WX  WX  WX  ST  WX  WX  WX  WX  WX  WX  GK  WX  ST  WX  WX  GK  WX  WX  WX  N
N  DF  QR                                             1                           1       1                N
N==DF======================================================================================================N
N99DF999999999999999999999999999999999999999999999999999999999999999999999999999999999999999999999999999999N
WIIIIIIIIIIIIIIIIIIIIIIIIIIIIIIIIIIIIIIIIIIIIIIIIIIIIIIIIIIIIIIIIIIIIIIIIIIIIIIIIIIIIIIIIIIIIIIIIIIIIIIIIIIX