# Map file for tile-based game
# (Lines that start with '#' are comments)
# The tiles are:
#   (Space) Empty tile
#   A..Z    Tiles A through Z
#   o       Star
#   !       Music Note
#   *       Goal
#   1       Bad Guy 1 (grub)
#   2       Bad Guy 2 (fly)
O         ABBBBBBBBBBBBBBBBBBBBBBBBBBBBBBBBBBBBBBBBBBBBBBBBBBBBBBBBBBBBBBBBBBBBBBBBBBBBBBBBBBBBBBBBBBBBBBBBC
N         DEEEEEEEEEEEEEEEEEEEEEEEEEEEEEEEEEEEEEEEEEEEEEEEEEEEEEEEEEEEEEEEEEEEEEEEEEEEEEEEEEEEEEEEEEEEEEEEEF
N         GHHHHHHHHHHHHHHHHHHHHHHHHHHHHHHHHHHHHHHHHHHHHHHHHHHHHHHHHHHHHHHHHHHHHHHHHHHHHHHHHHHHHHHHHHHHHHHHHK
N                                                                                                          O
N                                                                 5                               ooo!     N
N                              2              3                                                   o*o!     N
N              4                            3                                                   ABBBBBBC   N
N                                         3            5        2                    4          DEEEEEEF   N
N               5                                                      5                        GHHHHHHK   N
N                                                                                      4            ooooo  N
N                    4               5                                o1!                           ooooo  N
N            oooo   oooo                                              JIIL    JIIIIIIIL          ABBBBBBBBBN
N       JIIIIIIIIIIIIIIIL                         !   1  !              4                        DEEEEEEEEEN
N                        4                       JIIIIIIIIL                                  ABBBTEEEEEEEEEN
N                        1   !      1    4                                   3               DEEQHHHHHHREEEN
N                    ABBBBBBBBBBBBBBBC                                                       DEEF======DEEEN
N                    DEEEEEEEEEEEEEEEF                                                       DEEF999999DEEEN
N             2  o   DEEEEEEEEEEEEEEEF               2           2  5                   5    DEEF999999DEEEN
WIIIIIIIIIIIIIIIIIIIIIIIIIIIIIIIIIIIIIIIIIIIIIIIIIIIIIIIIIIIIIIIIIIIIIIIIIIIIIIIIIIIIIIIIIIIIIIIIIIIIIIIIIIX