# Map file for tile-based game
# (Lines that start with '#' are comments)
# The tiles are:
#   (Space) Empty tile
#   A..Z    Tiles A through Z
#   o       Star
#   !       Music Note
#   *       Goal
#   1       Bad Guy 1 (grub)
#   2       Bad Guy 2 (fly)
O         ABBBBBBBBBBBBBBBBBBBBBBBBBBBBBBBBBBBBBBBBBBBBBBBBBBBBBBBBBBBBBBBBBBBBBBBBBBBBBBBBBBBBBBBBBBBBBBBBC
N         DEEEEEEEEEEEEEEEEEEEEEEEEEEEEEEEEEEEEEEEEEEEEEEEEEEEEEEEEEEEEEEEEEEEEEEEEEEEEEEEEEEEEEEEEEEEEEEEEF
N         GHHHHHHHHHHHHHHHHHHHHHHHHHHHHHHHHHHHHHHHHHHHHHHHHHHHHHHHHHHHHHHHHHHHHHHHHHHHHHHHHHHHHHHHHHHHHHHHHK
N                                                                                                          O
N                                              3                                 4                ooo      N
N                              2              3                                    4              o*o      N
N                                           3                                                   ABBBBBBC   N
N                                         3                     2                    4          DEEEEEEF   N
N                                                                                               GHHHHHHK   N
N                                                                                      4            ooooo  N
N                                                                     o1!                           ooooo  N
N            oooo   oooo                                              JIIL    JIIIIIIIL          ABBBBBBBBBN
N       JIIIIIIIIIIIIIIIL                         !   1  !                                       DEEEEEEEEEN
N                                                JIIIIIIIIL                                  ABBBTEEEEEEEEEN
N                        1   !      1                                        3               DEEQHHHHHHREEEN
N                    ABBBBBBBBBBBBBBBC                                                       DEEF======DEEEN
N                    DEEEEEEEEEEEEEEEF                                                       DEEF999999DEEEN
N             2  o   DEEEEEEEEEEEEEEEF               2           2                      5    DEEF999999DEEEN
WIIIIIIIIIIIIIIIIIIIIIIIIIIIIIIIIIIIIIIIIIIIIIIIIIIIIIIIIIIIIIIIIIIIIIIIIIIIIIIIIIIIIIIIIIIIIIIIIIIIIIIIIIIX