# Map file for tile-based game
# (Lines that start with '#' are comments)
# The tiles are:
#   (Space) Empty tile
#   A..Z    Tiles A through Z
#   o       Star
#   !       Music Note
#   *       Goal
#   1       Bad Guy 1 (grub)
#   2       Bad Guy 2 (fly)

O         ABBBBBBBBBBBBBBBBBBBBBBBBBBBBBBBBBBBBBBBBBBBBBBBBBBBBBBBBBBBBBBBBBBBBBBBBBBBBBBBBBBBBBBBBBBBBBBBBC
N         DEEEEEEEEEEEEEEEEEEEEEEEEEEEEEEEEEEEEEEEEEEEEEEEEEEEEEEEEEEEEEEEEEEEEEEEEEEEEEEEEEEEEEEEEEEEEEEEEF
N         GHHHHHHHHHHHHHHHHHHHHHHHHHHHHHHHHHHHHHHHHHHHHHHHHHHHHHHHHHHHHHHHHHHHHHHHHHHHHHHHHHHHHHHHHHHHHHHHHK
N                                                                                                          O 
N                                              3                                 4                         N
N                              2              3                                    4                       N 
N                                           3                                      4            ABBBBBBC   N
N                                         3                     2                    4          DEEEEEEF   N
N                                                                                    4          GHHHHHHK   N
N                                                                                      4                   N
N                                                                                                         *N
N                                                                     o1!     JIIIIIIIL          ABBBBBBBBBN
N       JIIIIIIIIIIIIIIIL                                             JIIL                       DEEEEEEEEEN
N                                                         !   1  !                           ABBBTEEEEEEEEEN
N                        1   !      1                    JIIIIIIIIL          3               DEEQHHHHHHREEEN     
N                    ABBBBBBBBBBBBBBBC                                                  3    DEEF======DEEEN  
N                    DEEEEEEEEEEEEEEEF                                                       DEEF999999DEEEN
N             2  o   DEEEEEEEEEEEEEEEF               2                          2            DEEF999999DEEEN    
WIIIIIIIIIIIIIIIIIIIIIIIIIIIIIIIIIIIIIIIIIIIIIIIIIIIIIIIIIIIIIIIIIIIIIIIIIIIIIIIIIIIIIIIIIIIIIIIIIIIIIIIIIIX