# Map file for tile-based game
# (Lines that start with '#' are comments)
# The tiles are:
#   (Space) Empty tile
#   A..Z    Tiles A through Z
#   o       Star
#   !       Music Note
#   *       Goal
#   1       Bad Guy 1 (grub)
#   2       Bad Guy 2 (fly)

II        IIIIIIIIIIIIIIIIIIIIIIIIIIIIIIIIIIIIIIIIIIIIIIIIIIIIIIIIIIIIIIIIIIIIIIIIIIIIIIIIII
II        IIIIIIIIIIIIIIIIIIIIIIIIIIIIIIIIIIIIIIIIIIIIIIIIIIIIIIIIIIIIIIIIIIIIIIIIIIIIIIIIIIIIIIIIIIIIII
II        IIIIIIIIIIIIIIIIIIIIIIIIIIIIIIIIIIIIIIIIIIIIIIIIIIIIIIIIIIIIIIIIIIIIIIIIIIIIIIIIIIIIIIIIIIIIII
II                                                                                               IIIIIII
II                                                                                               IIIIIII
II                                                                                               IIIIIII
II                                                                                               IIIIIII
II                                                                                               IIIIIII
II                                                                                               IIIIIII
II                                                                                               IIIIIII
II                                                                                          *    IIIIIII
II                                                                    o1!     IIIIIIIII          IIIIIII
II       ABCDEFGHIJKLMNOPQRSTUVWX===================                  IIII                       IIIIIII
II                                                         !   1  !                              IIIIIII
II                        1   !      1                    IIIIIIIIII                             IIIIIII          
II                    IIIIIIIIIIIIIIIII                                                          IIIIIII       
II                    IJJJJJJJJJJJJJJJI                                                          IIIIIII
II             2  o   IJJJJJJJJJJJJJJJI               2                          2               IIIIIII        
IIBBBBBBBBBBBBBBBBBBBBBBBBBBBBBBBBBBBBBBBBBBBBBBBBBBBBBBBBBBBBBBBBBBBBBBBBBBBBBBBBBBBBBBBBBBBBBBBIIIIIII